ALL	AO L
CLOSE	K L OW S
CLOSE(2)	K L OW Z
FAIREST	F EH R IH S T
GO	G OW
HELP	HH EH L P
HIDE	HH AY D
IS	IH Z
MAGIC	M AE JH IH K
MIRROR	M IH R ER
MODULES	M AA JH UW L Z
OF	AH V
ON	AA N
ON(2)	AO N
ONE	W AH N
ONE(2)	HH W AH N
OPEN	OW P AH N
SHOW	SH OW
SLEEP	S L IY P
THE	DH AH
THE(2)	DH IY
TO	T UW
TO(2)	T IH
TO(3)	T AH
UP	AH P
VOICE	V OY S
WAKE	W EY K
WALL	W AO L
WHO	HH UW
